肉包	烧卖	高级猪肉	
御好烧	烧卖	面粉	秘传酱汁
饺子	烧卖	大葱	生姜
肉饺子	饺子	高级猪肉	
海鲜饺子	饺子	极品虾	卷心菜
牛肉饭	法式煎鸡	霜降牛肉	胡萝卜
儿童套餐	牛排饭	霜降牛肉	秘传酱汁
奶汁干酪菜	可乐饼	醇香黄油	鲜牛奶
天妇罗	可乐饼	极品虾	美味的鱼
凯撒沙拉	色拉	莴苣	奶酪
海鲜沙拉	色拉	幻之章鱼	
炒蔬菜	色拉	胡萝卜	卷心菜
煮菜	炒蔬菜	南瓜	白萝卜
活鱼生切	生鱼片	鲷鱼	幻之乌贼
特级寿司	生鱼片	无农药米	酱油
薯条	土司	北国马铃薯	
汉堡包	土司	霜降牛肉	
披萨土司	土司	番茄	
披萨	土司	熟奶酪	高级猪肉
巴菲	冰激凌	樱桃	
巧克力巴菲	巴菲	巧克力	
草莓巴菲	巴菲	草莓	
布丁	冰激凌	新鲜鸡蛋	
甜甜圈	冰激凌	面粉	
金箔冰激凌	冰激凌	金箔	


快活村 附近的杂木林、陡峭的山中、附近的农家
拳骨镇 休闲的牧场、人气鱼市、蔬菜市场
湖畔镇 海鲜市场、秘密的岩场、渔夫之家
元气镇 契约农家、高级鱼市场、熟人的店
云雀岭 巨型百货店、纽约市场、开罗岛
极品虾在秘密的岩场、渔夫之家、高级鱼市场中有一定几率会获得，并不是每次一定会获得的。。带的员工越多，员工鉴别食材的能力越强，发现的可能性越大！